                                                                                 /-------------------------------------\
          /----------------------------------\                   /---------------+-------------------------------------+--------\
         /+----------------------------------+-------------------+---------------+----------------------------------\  |        |
         ||                        /---------+-------------------+-\ /-----------+--------------\                   |  |        |    /--------\
         ||                 /------+--\      |            /------+-+-+-----------+--------------+--------------\    |  |        |    |        |
         ||                 |      |  |      |/-----------+------+-+-+-----------+--------------+--------------+----+--+--\     |    |        |
         || /---------------+------+--+------++-----------+--\   | | |           |      /-------+----\         |    |  |  |     |    |        |
         || |           /---+------+--+-\    ||           |  |   | | |           |      |       |   /+---------+----+--+--+-----+-\  |        |
         || |           |   |      |  | |    ||           |  |   | | |           |    /-+-------+---++---------+----+--+--+-----+-+--+\       |
         || |           |   |      |  | |    ||           | /+---+-+-+-----------+----+-+-------+---++\        |    |  |  |     | |  ||       |
         || |           | /-+------+--+-+----++-----------+\||   | | |           |    | |/------+---+++--------+----+--+\ |     | |  ||       |
         || |           | | |      |  | |    ||           ||||   | | |           |    | ||      |   |||        |    |  || |     | |  ||       |
         || |           | | | /----+--+-+----++-----------++++---+-+-+-----------+----+-++--\   |   |||        |    |/-++-+-----+-+--++-------+----\
/--------++-+-----------+-+-+-+----+--+-+----++-----------++++---+-+-+----\      |    |/++--+---+---+++--------+----++-++-+-----+-+\ ||       |    |
|        || |         /-+-+-+-+----+--+-+----++------\    ||||   | | |    |      |    ||||  |   |   |||        |    || || |     | || ||       |    |
|        || |         | | | | |    |  | |    ||      |    ||||   | | | /--+------+----++++--+---+---+++--------+----++\|| |     | || ||       |    |
|    /---++-+-------\ | | | | |    |  | |    ||      |    ||||   | | | |  |      |    ||||  |   |   ||| /------+----+++++-+-----+-++-++-----\ |    |
|    |   || |       | | | | | |    |  | |   /++------+----++++-\ | | | |  |      |    ||||  |   |   ||| |      |    ||||| |     | || ||     | |    |
|    |   || |       | | | | | |    |  | |   |||      |    ||||/+-+-+-+-+--+------+----++++--+---+---+++-+------+----+++++-+---\ | || ||     | |    |
|    |   || |   /---+-+-+-+-+-+----+-\| |   |||      |    |||||| | | | |  |      |    ||||  |   |   ||| |  /---+----+++++-+---+-+-++-++-----+-+-\  |
|/---+---++-+---+---+-+-+-+-+-+----+-++-+---+++------+----++++++-+-+\| |  |      |    ||||  |   |   ||| |  |   |    ||||| |   | | || ||     | | |  |
||   |   || |   |   | | | | | |    | || |  /+++------+----++++++-+-+++-+--+------+----++++--+---+---+++-+--+---+----+++++-+---+-+-++-++---\ | | |  |
||   |   || |   |   | | | | | |    | || |  ||||      |    |||||| | ||| |  |      |    ||||  |   |   ||| |  |   |    ||||| |   | | || ||   | | | |  |
||   |   || |   |   | | | | | |    | || |  ||||      | /--++++++-+-+++-+--+------+----++++--+---+---+++-+-\|   |    ||||| |   | | || ||   | | | |  |
||   |   || |   |   | | | | | |    | || |  ||||      | |  |||||| | ||| |  |      |    ||||  |   |   ||| | ||   |    ||||| |   |/+-++-++---+-+-+-+\ |
||   |   || |   |  /+-+-+-+-+-+----+-++-+--++++------+-+--++++++-+\||\-+--+------+----++++--+---//--+++-+-++---+--\ ||||| |   ||| || \+---+-+-/ || |
||   |   || |   |  || | | | \-+----+-+/ |  ||||      | |  |||||| |||| /+--+----\ |    ||||  |    |  ||| | ||   |  | ||||| |   ||| ||  |   | |   || |
||/--+---++-+---+--++-+-+-+---+----+-+--+-\||||      | |  |||||| |||| ||  |    | |    ||||  |    |  ||| | ||   |/-+-+++++-+--\||| ||  |   | |   || |
|||  |   \+-+---+--++-+-+-+---+----+-+--+-+++++------+-+--++++++-++++-++--+----+-+----++++--+----+--+++-+-++---++-+-/|||| |  |||| ||  |   | |   || |
|||/-+----+-+---+--++-+-+-+---+--\ | |  | |||||      | |  |||||| |||| ||  | /--+-+----++++--+----+--+++-+-++---++-+-\|||| |  |||| ||  |   | |   || |
\+++-+----+-+---+--++-+-+-+---+--+-+-+--+-+++++------+-+--++++++-++++-++--/ |  | |    |||| /+----+--+++-+-++---++-+\||||| |  |||| ||  |   | |   || |
 ||| |    | |   |  || | | |   |  | | |  | |||||      |/+--++++++-++++-++----+--+-+\   |||| ||    |  ||| | ||   || ||||||| |  |||| ||  |   | |   || |
 ||| |    | |   |  || | \-+---+--+-+-+--/ |||||      |||  |||||| |||| ||    |  | ||   |||| ||    |  ||| | ||   || ||||||| |  |||| ||  |   | |   || |
 ||| |    | |   |/-++-+---+---+--+-+-+----+++++------+++--++++++-++++-++----+\ | ||   |||| ||    |  ||| | ||   ||/+++++++-+--++++-++--+---+\|   || |
 ||| | /--+-+---++-++\|   |   |  | | |    |||||      |||  \+++++-++++-++----++-+-++---++++-++----+--+++-+-++---/||||||||| |  |||| ||  |   |||   || |
 ||| | |  | |   || ||||   |   |  | | |    |||||      ||| /-+++++-++++-++----++\| || /-++++-++----+--+++-+-++----+++++++++-+--++++\||  |   |||   || |
 ||| | |  | |   || ||||   |   |/-+-+-+----+++++------+++-+-+++++-++++-++----++++-++-+-++++-++----+--+++-+-++----+++++++++-+--+++++++--+-\ |||   || |
 ||| | |  | |   ||/++++---+---++-+-+-+----+++++------+++-+-+++++-++++-++----++++-++-+-++++-++----+--+++-+-++\   ||||||||| |  |||||||  | | |||   || |
 ||| | |  | |   |||||||   | /-++-+-+-+----+++++\     ||| | ||||| |||| ||    |||| || | |||| ||    |  ||| | |||   \++++++++-+--/||||||  | | |||   || |
 ||| | |  | |   |||||||   | | || |/+-+----++++++-----+++-+-+++++-++++-++----++++-++-+-++++-++----+--+++-+-+++----++++++++-+---++++++--+-+\|||   || |
 ||| | |  | |   |||||||   | | || ||| |  /-++++++-----+++-+-+++++-++++-++----++++-++-+-++++-++----+--+++-+-+++-\/-++++++++\|   ||||||  | |||||   || |
 ||| | |  | |   |||||||   | | || ||| |  | ||||||     ||| | ||||| |||| ||    |||| || | ||||/++----+--+++\| ||| || ||||||||||   ||||||  | |||||   || |
 ||| | |  | |   |||||||   | | || ||| |  | ||||||/----+++-+-+++++-++++-++----++++-++\| |||||||    |  ||||| ||| || ||||||||||   ||||||  | |||||   || |
 |||/+-+--+-+-\ |||||||   | | || ||| |  | |||||||    ||| | ||||| |||| ||    |||| |||| |||||||    |  ||||| ||| || ||||||||||   ||||||  | |||||   || |
 |||||/+--+-+-+-+++++++---+-+-++-+++-+--+-+++++++----+++-+-+++++-++++-++----++++-++++-+++++++----+--+++++-+++-++\||||||||||   ||||||  | |||||   || |
 |||||||  | | | |||||||   | | || ||| |  | |||||||    ||| | ||||| |||| ||    |||| |||| |||||||    |  |||||/+++-+++++++++++++---++++++--+-+++++---++-+\
 |||||||  | | | |||||||   | | || ||| |  | |||||||    ||| | |||\+-++++-++----++++-++++-+++++++----+--+++++++++-+++++++++++++---/|||||  | |||||   || ||
 |||||||  | | | |||||||   | | || |||/+--+-+++++++----+++-+-+++-+-++++-++----++++-++++-+++++++--\ |  ||||||||| |||||||||||||    |||||  | |||||   || ||
 |||||||  | | | |||||||   | | || ||\++--+-+++++++----+++-+-+++-+-++/| ||    |||| |||| ||||||| /+-+--+++++++++-+++++++++++++---\|||||  | |||||   || ||
 |||||||  | | | |||\+++---+-+-++-++-++--+-+++++++----+++-+-+++-+-+/ | ||    |||| |||| ||||||| || |  ||||||||| |||||||||||||   ||||||  | |||||   || ||
 |||||||  | | | ||| |||   | | || || ||  | |||||||    ||| | ||| | |  | ||    |||| |||| |||||\+-++-+--+++++++++-+++++/|||||||   ||||||  | |||||   || ||
 |||||||  | | | ||| |||/--+-+-++-++-++--+-+++++++----+++-+-+++-+-+\ | ||    |||| |||| ||||| | || |  ||||||||| ||||| |||||||   ||||||  | |||||   || ||
 |||\+++--+-+-/ ||| ||||  | | || || ||  | |||||||    ||| | ||| | || | ||    |||| |||| ||||| | || |  |||||||\+-+++++-+++++++---++++++--+-+++++---/| ||
 ||| |||  | |   ||| ||||  | | || || ||  | |||||||    ||| | ||| | || | ||    |||| |||| ||||| | || |  ||||||| | ||||| |||||||   ||||||  | |||||    | ||
 ||| |||  | |   ||| ||||  | | || || ||  | |||||||/---+++-+-+++-+-++-+-++----++++-++++-+++++-+-++-+--+++++++-+-+++++\|||||||   ||||||  | |||||    | ||
 ||| |||  | |   ||| ||||  | | || || ||  | ||||||||   ||| | ||| | || | ||    |||| |||| ||||| | || |  ||||||| | |||||||||||||   ||||||  | |||||    | ||
 ||| |||  | |   ||| ||||  | | || || ||  | ||||||||   ||| | |\+-+-++-+-++----++++-++++-+++++-+-++-+--++/|||| | |||||||||||||   ||||||  | |||||    | ||
 ||| |||  |/+---+++-++++--+-+-++-++-++--+-++++++++---+++-+\| | | || | ||    |||| |||| ||||| | || |  || |||| | |||||||||||||   ||||||  | |||||    | ||
 ||| |||  |||   ||| ||||  | | || || || /+-++++++++---+++-+++-+-+-++-+-++----++++-++++-+++++-+-++-+--++-++++-+-+++++++++++++---++++++--+-+++++--\ | ||
 ||| |||  |||   ||| |||| /+-+-++-++-++-++-++++++++---+++-+++-+-+-++-+-++----++++-++++-+++++-+-++-+--++-++++-+-+++++++++++++---++++++\ | |||||  | | ||
 ||| |||  |||   ||| |||| || |/++-++-++-++-++++++++---+++-+++-+-+-++-+-++----++++-++++-+++++-+-++-+--++\|||| | |||||||||||||   ||||||| | |||||  | | ||
 ||| |||  |||   ||| |||| || |||| || || || ||||\+++---+++-+++-+-+-++-+-++----++++-++++-+++++-+-++-+--+++++++-+-++++++++++++/   ||||||| | |||||  | | ||
 ||| |||  |||   ||| ||\+-++-++++-++-++-++-++++-+++---/|| ||| | | || | ||    |||| |||| ||||| | \+-+--+++++++-+-++++++++++++----/|||||| | |||||  | | ||
 ||| |||  |||   ||| || | || |||| || || || |||| |||/---++-+++-+-+-++-+-++-\  |||| |||| ||||| |  | |  ||||||| | |\+++++++++/     |||||| | |||||  | | ||
 ||| |||  |||   ||| || | || |||| || || || |||| ||||   || ||| | | ||/+-++-+--++++-++++-+++++-+--+-+--+++++++-+-+-+++++++++------++++++-+-+++++--+-+\||
 ||| |||  |||   ||| || | || |||| || || || |||| ||||   || ||| | | |||| || |  |||| |||| ||||| |  | |  ||||||| | | |||||||||      |||||| | |||||  | ||||
 ||| ||\--+++---+++-+/ | || |||| || || || |||| ||||   || ||| | | |||| || |  |||| |||| ||||| |  | |  ||||||| | | |||||||||      |||||| | |||||  | ||||
 ||| ||   |||   ||| |  | || |||| || || || |||| ||||   || \++-+-+-++++-++-+--++/| |||| ||||| |/-+-+--+++++++-+-+-+++++++++\     |||||| | |||||  | ||||
 ||| ||   |||   ||| |  | || |||| || || || |||| ||||   \+--++-+-+-++++-++-+--++-+-+/|| |||||/++-+-+--+++++++-+-+-++++++++++\    |||||| | |||||  | ||||
 ||| ||   |||   ||| |  | || |||| || || || |||| ||||    |/-++-+-+-++++\|| |  || | | || |||||||| | |  ||||||| | | |||||||||||    |||||| | |||||  | ||||
 |||/++---+++\  ||| |  | || |||| || || ||/++++-++++----++-++-+-+-+++++++-+--++-+-+-++-++++++++-+-+--+++++++-+-+-+++++++++++--\ |||||| | |||||  | ||||
 ||||||   ||||  ||| |  | || |||| || ||/+++++++-++++----++-++-+-+-+++++++-+--++-+-+-++-++++++++-+-+--+++++++-+-+-+++++++++++--+-++++++\| |||||  | ||||
 ||||||   ||||  ||| |  | || ||||/++-++++++++++-++++----++-++-+-+-+++++++-+--++-+-+-++-++++++++-+-+--+++++++-+-+-+++++++++++--+-++++++++\|||||  | ||||
 ||||||   ||||  ||| |  | || ||||||| |||||||||| ||||    || || | | ||||||| |  || | | || |||||||| | |  ||||||| | | |||||||||||  | ||||||||||||||  | ||||
 ||||||   ||||  ||| |  | || ||||||| |||||||||| ||||    || || | | ||||||| |  || | | || ||\+++++-+-+--+/||||| | | |||||||||||  | ||||||||||||||  | ||||
 ||||||   ||||  ||| |  | || |\+++++-++++++++++-++++----++-++-+-+-+++++++-+--++-+-+-++-++-+++++-+-+--+-/|||| | | |||||||||||  | ||||||||||||||  | ||||
 ||||||   ||||  ||| |  | || | ||||| |||||||||| ||||    || || | | ||||||| |  || | | || || ||||\-+-+--+--++++-+-+-+++++++++/|  | ||||||||||||||  | ||||
 ||||||   ||||  ||| |  | || | ||||| |||\++++++-++++----++-++-+-+-+++++++-+--++-+-+-++-++-++++--+-+--+--++++-+-+-+++++++++-+--+-++++++++++++++--/ ||||
 ||||||   ||||  ||| |  | ||/+-+++++-+++-++++++-++++----++-++-+-+-+++++++-+--++-+-+-++-++-++++--+-+--+--++++-+-+-+++++++++-+\ | ||||||||||||||    ||||
 ||||||   ||||  ||| |  | |||\-+++++-+++-++++++-/|||    || || | |/+++++++-+--++-+-+-++-++-++++--+-+--+--++++-+\| ||||||||| || | ||||||||||||||    ||||
 ||||||   \+++--+++-+--+-+++--+++++-+++-+++++/  |||    || || | ||||||||| |  \+-+-+-++-++-++++--+-+--+--++++-+++-++++/|||| || | ||||||||||||||    ||||
 ||||||    |||  ||| |  | |||  ||||| ||| |||||   |||    || || | ||||||||| |   | | | || || ||||  | |  |  |||| ||| |||| |||| || | ||||||||||||||    ||||
/++++++----+++--+++-+--+-+++--+++++-+++-+++++---+++----++-++-+-+++++++++-+\  | | |/++-++-++++--+-+--+--++++-+++-++++\|||| || | ||||||||||||||    ||||
|||||||    |||  ||| |  | \++--+++++-+++-+++++---+++----++-++-+-+++++++++-++--+-+-++++-++-++++--+-+--+--++++-+++-+++++++++-++-+-+++++/||||||||    ||||
|||||||    |||  ||| |  |  ||  ||||| |||/+++++---+++----++\||/+-+++++++++-++--+-+-++++-++-++++--+-+--+--++++-+++-+++++++++-++-+-+++++-++++++++\   ||||
|||||||    |||  ||| |  |  ||  ||||| |||||||||   |||    |||||||/+++++++++-++--+-+\|||| || ||||  | |  |  |||| ||| ||||||||| || | ||||| |||||||||   ||||
|||||||    |||  ||| |  |  ||  \++++-+++++++++---+++----+++++++++++++++++-++--+-++++++-++-+++/  | |  \--++++-+++-+++++++++-++-+-+++/| |||||||||   ||||
|||||||/---+++--+++-+--+--++---++++-+++++++++---+++----+++++++++++++++++-++--+-++++++-++-+++--\| |     |||| ||| ||||||||| || | ||| | |||||||||   ||||
||||||||   |||  \++-+--+--++---++++-+/|||||||   |||    \++++++++++++++++-++--+-++++++-++-+++--++-+-----+++/ ||| ||||||||| || | ||| | |||||||||   ||||
||||||||   |||   || |  |  ||   |||| | ||||||\---+++-----+++++++/|\++++++-++--+-++++++-++-+++--++-+-----+++--+++-+++++++++-++-+-+/| | |||||||||   ||||
||||||||   |||   || |  |  ||   |||| | ||||||    |||     ||||||| | |||||| ||  | |||||| || |||  || |    /+++--+++-+++++++++-++\| | | | |||||||||   ||||
||||||||   |||   || |  |  ||   |||| | ||||||    |||     ||||||| | |||||| ||  | |||||| || |||  || |    ||||  ||| ||||||||| |||| | | | |||||||||   ||||
||||||||/--+++---++\|  |  ||   |||| | ||||||    |||     ||||||| | |||||| ||  | ||\+++-++-+++--++-+----++++--+++-+++++++/| |||| | | | |||||||||   ||||
|||||||||  |||   ||||  |  ||   |||| | ||||||    \++-----+++++++-+-++++++-++--+-++-+/| || |||  || |    ||||  ||| ||||||| | |||| | | | |||||||||   ||||
|||||||||  |||   ||||  |  ||   |||| | ||||||     ||     ||||||| | |||||| ||  | || | | || ||| /++-+----++++--+++-+++++++-+\|||| | | | |||||||||   ||||
|||||||||  |||   ||||  |  ||   |||| | |\++++-----++-----+/||||| | |||||| ||  | || | | || ||| ||| |    ||||  ||| ||||||| |||||| | | | |||||||||   ||||
|||||||||  |||   ||||  |  ||   |||| | | ||||/----++-----+-+++++-+-++++++-++--+-++-+-+\|| ||| ||| |    ||||  ||| |||||\+-++++++-+-+-+-+++++++++---++/|
|||||||||  |||   ||||  |  ||   |||\-+-+-+++++----++-----+-+++++-+-++++++-++--+-++-+-++++-+++-+++-+----++++--+++-+++++-+-++++++-+-+-+-++++/||||   || |
|||||||||  ||| /-++++--+--++---+++--+-+-+++++---\||     \-+++++-+-+++/|| ||  | || | |||| ||| ||| |    ||||  ||| ||||| | |||||| | | | |||| ||||   || |
|||||\+++--+++-+-+++/  |  |\---+++--+-+-+++++---+++-------+++++-+-+++-++-++--+-++-+-++++-+++-+++-+----++++--+++-+++++-+-+++/|| | | | |||| ||||   || |
|||\+-+++--+++-+-+++---+--+----++/  | | |||||   |||       ||||| | ||| || ||  | || | |||| ||| ||| |    ||||  ||| ||||| | ||| || | | | |||| ||||   || |
||| | |||  ||| | |||   |  |    ||   | | |||||   |||       ||||| | ||| || ||  | || | |||| ||| ||| \----++++--+++-++/|| | ||| || | | | |||| ||||   || |
||| | |||  ||| | \++---+--+----++---+-+-+++++---+++-------+++++-+-+++-++-++--/ || | |||| \++-+++------++++--+++-++-++-+-/|| || | | | |||| ||||   || |
||| | |||  ||| |  ||   |  |   /++---+-+\|||||   |||       ||||| | ||| || ||    || | ||\+--++-+++------++++--+++-++-++-+--++-++-+-+-+-+/|| ||||   || |
||| | |||  ||| |  ||   |  |   |||   | |||||||   |||       ||||| | ||| || || /--++-+-++-+--++-+++------++++--+++-++-++\|  || || | | | | || ||||   || |
||| | |||  |\+-+--++---+--+---+++---+-+++++++---+++-------+++/| | ||| |\-++-+--++-+-++-+--++-+++------++++--+++-++-+++/  || || | | | | || ||||   || |
||| | |||  | | |  ||   |  |   |||   | |||||||   |||       ||| | | ||| |  || |  || | || |  || |||      ||||  ||| || |||   || || | | | | || ||||   || |
||| | |||  | | |  ||   |  \---+++---+-+++++++---+++-------+/| | | ||| |  || |  || | || |  || |||      ||||  ||| || |||   || || | | | | || ||||   || |
||| | |||  | | |/-++---+---\  |||   | |||||||   |||       | | | | ||| |  || |  || | || |  || |||      \+++--+++-++-+++---++-/| | | | | || ||||   || |
||| | |||  | | || ||   |   |  |||   | |||||||  /+++------\| | | | ||| |  || |  || | || |  || |||       |||  ||| || |||   ||  | | | | | || ||||   || |
||| | |||  | | || ||   |   |  |||   | ||\++++--++++------++-+-+-+-+++-+--++-+--++-+-++-+--++-+++-------+++--++/ || |||   ||  | | | | | || ||||   || |
||| | |||  | | || ||   |   |  |||  /+-++-++++--++++------++-+-+-+-+++-+--++-+--++-+-++-+-\|| |||       ||| /++--++-+++---++--+-+-+-+-+-++-++++--\|| |
||| \-+++--+-/ || ||   |   |  ||\--++-++-++++--++++------++-+-+-+-+++-+--++-+--++-+-++-+-+++-+++-------+++-+++--++-+++---++--+-+-+-+-+-/| ||||  ||| |
|\+---+++--+---++-++---+---+--++---++-++-++++--++++------++-+-+-+-++/ |  || |  || | || | ||| |||       ||| |||  || |||   ||  | | | | |  | ||||  ||| |
\-+---+++--+---++-++---+---+--++---++-++-++++--++++------++-+-+-+-++--+--+/ |  || \-++-+-+++-+++-------+++-+++--++-+/|   ||  | | | | |  | ||||  ||| |
  |   ||| /+---++-++---+---+--++---++-++-++++--++++------++-+-+-+-++--+--+--+--++--\|| | ||| |||       ||| |||  || | |   ||  | | | | |  | ||||  ||| |
  |   ||| ||   ||/++---+---+--++---++-++-++++--++++------++-+-+-+-++--+-\|  \--++--+++-+-+++-+++-------+++-+++--++-+-/   ||  | | | | |  | ||||  ||| |
  |   ||| ||   |\+++---+---/  ||   || || ||||  ||||      || | | | ||  | ||     ||  ||| | ||\-+++-------+++-+++--++-+-----+/  | | | | |  | ||||  ||| |
  |   ||| ||   | |||   |      ||   || || ||||  ||||      || | | | ||  | ||     ||  ||| \-++--+++-------+++-+++--++-+-----+---+-+-+-/ |  | ||||  ||| |
/-+---+++-++--\| |||   |    /-++---++-++-++++--++++------++-+-+-+-++\ | ||     ||  |||   ||  |||       ||| |||  || |     |   | \-+---+--+-++++--+/| |
| |   ||| ||  || |||   |    | ||   || || ||||  ||||      || | | | ||| | ||     ||  |||   ||  |||       ||| |||  || |     |   |   |   |  | ||||  | | |
| |   ||| ||  || |||   |    | ||   || || ||||  ||||      || | | | ||| | ||     ||  |||   ||  |||       |\+-+++--++-+-----+---+---+---+--+-++/|  | | |
| \---+++-++--++-+++---+----+-++---++-++-+/||  ||||      || | | | |\+-+-++-----++--+++---++--+++-------+-+-+++--++-+-----+---+---+---+--+-++-+--+-/ |
|     ||| ||  || |||   |    | \+---++-+/ | ||  ||||      || | | | | | | ||     ||  |||/--++--+++-------+-+-+++--++-+-----+--\|   |   |  | || |  |   |
|     ||| ||  || |||   |    |  |   || |  | ||  ||||      || | | | | | | ||     ||  ||||  ||  |||       | | |||  || |     |  ||   |   |  | || |  |   |
|     ||| ||  || |||   |    |  |   || |  \-++--++++------++-+-+-+-+-+-+-++-----++--++++--++--+++-------+-+-+++--++-+-----+--+/   |   |  | || |  |   |
|     ||| ||  || \++---+----+--+---++-+----++--++++------++-+-+-+-+-+-+-/|     ||  ||||  ||  |||       | | |||  || |     |  |    |   |  | || |  |   |
|     ||| ||  ||  ||   |    |  |   || |    \+--++++------++-+-+-+-+-+-+--+-----++--++++--++--+++-------+-+-+++--++-+-----+--+----+---+--+-/| |  |   |
|     ||| ||  ||  ||   |    |  \---++-+-----+--++++------++-+-+-+-+-+-+--+-----++--++++--++--+++-------+-+-+++--++-+-----+--+----+---+--/  | |  |   |
\-----+++-++--/|  ||   |    |      || \-----+--++++------++-+-+-+-+-+-+--+-----++--++++--++--+++-------+-+-+++--++-+-----+--+----+---/     | |  |   |
      ||| ||   |  ||   |    |      ||       |  ||||      || \-+-+-+-+-+--+-----++--++++--++--+++-------+-+-+++--++-+-----+--+----+---------+-/  |   |
      ||| \+---+--++---+----+------++-------+--++++------++---+-+-+-+-+--+-----++--/|||  ||  |||       | | |||  || |     |  |    |         |    |   |
      |||  \---+--++---+----+------++-------+--++++------+/   | | | | \--+-----/|   |||  ||  |||   /---+-+-+++--++-+-----+--+----+----\    |    |   |
      |||      |  ||   |    |      ||       |  ||||      |    | | | |    |      |   |||  ||  \++---+---+-+-+++--++-+-----/  |    |    |    |    |   |
      |||      |  ||   |    |      ||       |  |||\------+----+-+-+-+----/      |   |||  ||   ||   |   | | |||  || |        |    |    |    |    |   |
      |||      |  ||   |    |      ||       |  |||       |    \-+-+-+-----------/   |||  |\---++---+---/ | \++--++-+--------+----+----+----+----/   |
      |||      |  ||   |    |      |\-------+--+++-------+------+-+-+---------------+++--+----+/   |     |  ||  || |        |    |    |    |        |
      |||      |  ||   \----+------+--------+--+++-------+------+-/ |               \++--+----+----+-----+--++--++-+--------+----/    |    |        |
      |\+------+--++--------+------+--------+--+++-------+------+---+----------------++--+----/    |     |  ||  |\-+--------+---------+----/        |
      | \------+--+/        \------+--------+--+++-------+------+---/                |\--+---------+-----+--++--+--+--------/         |             |
      \--------+--+----------------+--------+--+++-------+------+--------------------+---+---------+-----+--++--/  |                  |             |
               |  |                |        |  |||       |      |                    |   |         \-----+--++-----+------------------/             |
               \--+----------------+--------+--+/|       |      |                    |   |               |  ||     |                                |
                  \----------------+--------+--+-+-------+------+--------------------+---+---------------+--/|     |                                |
                                   |        |  | |       |      |                    |   |               |   |     |                                |
                                   |        |  \-+-------/      |                    |   |               |   |     |                                |
                                   |        |    |              \--------------------+---+---------------+---/     |                                |
                                   |        \----+-----------------------------------/   |               \---------+--------------------------------/
                                   |             \---------------------------------------+-------------------------/
                                   \-----------------------------------------------------/
